7888888888888888888888888889
4                          6
4                          6
4                          6
4                          6
4                          6
4                          6
4                          6
4                          6
4                          6
4                          6
4                          6
4         78~~~~89         6
4         4~~~~~~6         6
4         4~GGGG~6         6
4         4~~~~~~6         6
4         12222223         6
4            C             6
4                          6
4                          6
4                          6
4                          6
4                          6
4            S             6
4                          6
4                          6
4                          6
4                          6
4                          6
4                          6
1222222222222222222222222223